 Map file  is long 617 lines 
 Ecal values read =  616 
 Temp sensor lines =32 
 sensors read L/C = 20
 ii=322 - PMT 2104086 - tsens1=214 - tsens2=213 
 ii=335 - PMT 2103097 - tsens1=206 - tsens2=0 
 ii=361 - PMT 2103063 - tsens1=212 - tsens2=0 
 ii=390 - PMT 2103107 - tsens1=220 - tsens2=219 
 ii=408 - PMT 2104032 - tsens1=208 - tsens2=0 
 ii=418 - PMT 2104180 - tsens1=203 - tsens2=0 
 ii=456 - PMT 2103047 - tsens1=205 - tsens2=0 
 ii=461 - PMT 2103027 - tsens1=217 - tsens2=0 
 ii=465 - PMT 2103017 - tsens1=218 - tsens2=0 
 ii=509 - PMT 2105130 - tsens1=207 - tsens2=0 
 ii=544 - PMT 2103033 - tsens1=216 - tsens2=215 
 ii=557 - PMT 2104058 - tsens1=202 - tsens2=0 
 ii=564 - PMT 2105107 - tsens1=211 - tsens2=0 
 ii=583 - PMT 2104063 - tsens1=204 - tsens2=0 
 ii=600 - PMT 2103018 - tsens1=201 - tsens2=0 
 ii=607 - PMT 2105203 - tsens1=210 - tsens2=209 


     -1      -1      -1      -1      -1      -1      -1      -1      -1      -1      -1      -1       0       0       0       0       0      -1      -1      -1      -1      -1      -1      -1      -1      -1      -1      -1      -1 
     -1      -1      -1      -1      -1      -1      -1      -1      -1       0       0       0       0       0       0       0       0       0       0       0      -1      -1      -1      -1      -1      -1      -1      -1      -1 
     -1      -1      -1      -1      -1      -1      -1       0 2103051       0       0       0       0       0 2103004       0       0       0       0       0 2105234       0      -1      -1      -1      -1      -1      -1      -1 
     -1      -1      -1      -1      -1       0       0       0       0       0       0       0       0       0       0       0       0       0       0       0       0       0       0       0      -1      -1      -1      -1      -1 
     -1      -1      -1      -1       0       0       0       0       0       0       0       0       0       0       0       0       0       0       0       0       0       0       0       0       0      -1      -1      -1      -1 
     -1      -1      -1       0       0       0       0       0       0       0       0       0       0       0       0       0       0       0       0       0       0       0       0       0       0       0      -1      -1      -1 
     -1      -1      -1       0       0       0       0       0       0       0       0       0       0       0 2103019       0       0       0       0       0       0       0       0       0       0       0      -1      -1      -1 
     -1      -1 2104068       0       0       0 2103152       0       0       0       0       0       0       0       0       0       0       0       0       0       0       0 2104037       0       0       0 2104132      -1      -1 
     -1      -1       0       0       0       0       0       0       0       0       0       0       0       0       0       0       0       0       0       0       0       0       0       0       0       0       0      -1      -1 
     -1       0       0       0       0       0       0       0       0       0       0       0       0       0       0       0       0       0       0       0       0       0       0       0       0       0       0       0      -1 
     -1       0       0       0       0       0       0       0       0       0 2104093       0       0       0       0       0       0       0 2105137       0       0       0       0       0       0       0       0       0      -1 
     -1       0       0       0 2103190       0       0       0       0       0       0       0       0       0 2103197       0       0       0       0       0       0       0       0       0 2105135       0       0       0      -1 
      0       0       0       0       0       0       0       0       0       0       0       0      -1      -1      -1      -1      -1       0       0       0       0       0       0       0       0       0       0       0       0 
      0       0       0       0       0       0       0       0       0       0       0       0      -1      -1      -1      -1      -1       0       0       0       0       0       0       0       0       0       0       0       0 
      0       0 2104072       0       0       0 2103124       0       0       0       0 2104180      -1      -1      -1      -1      -1 2105204       0       0       0       0 2104058       0       0       0 2103018       0       0 
      0       0       0       0       0       0       0       0       0       0       0       0      -1      -1      -1      -1      -1       0       0       0       0       0       0       0       0       0       0       0       0 
      0       0       0       0       0       0       0       0       0       0       0       0      -1      -1      -1      -1      -1       0       0       0       0       0       0       0       0       0       0       0       0 
     -1       0       0       0 2103097       0       0       0       0       0       0       0       0       0 2103047       0       0       0       0       0       0       0       0       0 2104063       0       0       0      -1 
     -1       0       0       0       0       0       0       0       0       0 2104032       0       0       0       0       0       0       0 2105130       0       0       0       0       0       0       0       0       0      -1 
     -1       0       0       0       0       0       0       0       0       0       0       0       0       0       0       0       0       0       0       0       0       0       0       0       0       0       0       0      -1 
     -1      -1       0       0       0       0       0       0       0       0       0       0       0       0       0       0       0       0       0       0       0       0       0       0       0       0       0      -1      -1 
     -1      -1 2104086       0       0       0 2103063       0       0       0       0       0       0       0       0       0       0       0       0       0       0       0 2105107       0       0       0 2105203      -1      -1 
     -1      -1      -1       0       0       0       0       0       0       0       0       0       0       0 2103027       0       0       0       0       0       0       0       0       0       0       0      -1      -1      -1 
     -1      -1      -1       0       0       0       0       0       0       0       0       0       0       0       0       0       0       0       0       0       0       0       0       0       0       0      -1      -1      -1 
     -1      -1      -1      -1       0       0       0       0       0       0       0       0       0       0       0       0       0       0       0       0       0       0       0       0       0      -1      -1      -1      -1 
     -1      -1      -1      -1      -1       0       0       0       0       0       0       0       0       0       0       0       0       0       0       0       0       0       0       0      -1      -1      -1      -1      -1 
     -1      -1      -1      -1      -1      -1      -1       0 2103107       0       0       0       0       0 2103017       0       0       0       0       0 2103033       0      -1      -1      -1      -1      -1      -1      -1 
     -1      -1      -1      -1      -1      -1      -1      -1      -1       0       0       0       0       0       0       0       0       0       0       0      -1      -1      -1      -1      -1      -1      -1      -1      -1 
     -1      -1      -1      -1      -1      -1      -1      -1      -1      -1      -1      -1       0       0       0       0       0      -1      -1      -1      -1      -1      -1      -1      -1      -1      -1      -1      -1 

 -1 -1 -1 -1 -1 -1 -1 -1 -1 -1 -1 -1  0  0  0  0  0 -1 -1 -1 -1 -1 -1 -1 -1 -1 -1 -1 -1
 -1 -1 -1 -1 -1 -1 -1 -1 -1  0  0  0  0  0  0  0  0  0  0  0 -1 -1 -1 -1 -1 -1 -1 -1 -1
 -1 -1 -1 -1 -1 -1 -1  0  0  0  0  0  0  0  0  0  0  0  0  0  0  0 -1 -1 -1 -1 -1 -1 -1
 -1 -1 -1 -1 -1  0  0  0  0  0  0  0  0  0  0  0  0  0  0  0  0  0  0  0 -1 -1 -1 -1 -1
 -1 -1 -1 -1  0  0  0  0  0  0  0  0  0  0  0  0  0  0  0  0  0  0  0  0  0 -1 -1 -1 -1
 -1 -1 -1  0  0  0  0  0  0  0  0  0  0  0  0  0  0  0  0  0  0  0  0  0  0  0 -1 -1 -1
 -1 -1 -1  0  0  0  0  0  0  0  0  0  0  0  0  0  0  0  0  0  0  0  0  0  0  0 -1 -1 -1
 -1 -1  0  0  0  0  0  0  0  0  0  0  0  0  0  0  0  0  0  0  0  0  0  0  0  0  0 -1 -1
 -1 -1  0  0  0  0  0  0  0  0  0  0  0  0  0  0  0  0  0  0  0  0  0  0  0  0  0 -1 -1
 -1  0  0  0  0  0  0  0  0  0  0  0  0  0  0  0  0  0  0  0  0  0  0  0  0  0  0  0 -1
 -1  0  0  0  0  0  0  0  0  0  0  0  0  0  0  0  0  0  0  0  0  0  0  0  0  0  0  0 -1
 -1  0  0  0  0  0  0  0  0  0  0  0  0  0  0  0  0  0  0  0  0  0  0  0  0  0  0  0 -1
  0  0  0  0  0  0  0  0  0  0  0  0 -1 -1 -1 -1 -1  0  0  0  0  0  0  0  0  0  0  0  0
  0  0  0  0  0  0  0  0  0  0  0  0 -1 -1 -1 -1 -1  0  0  0  0  0  0  0  0  0  0  0  0
  0  0  0  0  0  0  0  0  0  0  0 203 -1 -1 -1 -1 -1  0  0  0  0  0 202  0  0  0 201  0  0
  0  0  0  0  0  0  0  0  0  0  0  0 -1 -1 -1 -1 -1  0  0  0  0  0  0  0  0  0  0  0  0
  0  0  0  0  0  0  0  0  0  0  0  0 -1 -1 -1 -1 -1  0  0  0  0  0  0  0  0  0  0  0  0
 -1  0  0  0 206  0  0  0  0  0  0  0  0  0 205  0  0  0  0  0  0  0  0  0 204  0  0  0 -1
 -1  0  0  0  0  0  0  0  0  0 208  0  0  0  0  0  0  0 207  0  0  0  0  0  0  0  0  0 -1
 -1  0  0  0  0  0  0  0  0  0  0  0  0  0  0  0  0  0  0  0  0  0  0  0  0  0  0  0 -1
 -1 -1  0  0  0  0  0  0  0  0  0  0  0  0  0  0  0  0  0  0  0  0  0  0  0  0  0 -1 -1
 -1 -1 214  0  0  0 212  0  0  0  0  0  0  0  0  0  0  0  0  0  0  0 211  0  0  0 210 -1 -1
 -1 -1 -1  0  0  0  0  0  0  0  0  0  0  0 217  0  0  0  0  0  0  0  0  0  0  0 -1 -1 -1
 -1 -1 -1  0  0  0  0  0  0  0  0  0  0  0  0  0  0  0  0  0  0  0  0  0  0  0 -1 -1 -1
 -1 -1 -1 -1  0  0  0  0  0  0  0  0  0  0  0  0  0  0  0  0  0  0  0  0  0 -1 -1 -1 -1
 -1 -1 -1 -1 -1  0  0  0  0  0  0  0  0  0  0  0  0  0  0  0  0  0  0  0 -1 -1 -1 -1 -1
 -1 -1 -1 -1 -1 -1 -1  0 220  0  0  0  0  0 218  0  0  0  0  0 216  0 -1 -1 -1 -1 -1 -1 -1
 -1 -1 -1 -1 -1 -1 -1 -1 -1  0  0  0  0  0  0  0  0  0  0  0 -1 -1 -1 -1 -1 -1 -1 -1 -1
 -1 -1 -1 -1 -1 -1 -1 -1 -1 -1 -1 -1  0  0  0  0  0 -1 -1 -1 -1 -1 -1 -1 -1 -1 -1 -1 -1

 -1 -1 -1 -1 -1 -1 -1 -1 -1 -1 -1 -1  0  0  0  0  0 -1 -1 -1 -1 -1 -1 -1 -1 -1 -1 -1 -1
 -1 -1 -1 -1 -1 -1 -1 -1 -1  0  0  0  0  0  0  0  0  0  0  0 -1 -1 -1 -1 -1 -1 -1 -1 -1
 -1 -1 -1 -1 -1 -1 -1  0  0  0  0  0  0  0  0  0  0  0  0  0  0  0 -1 -1 -1 -1 -1 -1 -1
 -1 -1 -1 -1 -1  0  0  0  0  0  0  0  0  0  0  0  0  0  0  0  0  0  0  0 -1 -1 -1 -1 -1
 -1 -1 -1 -1  0  0  0  0  0  0  0  0  0  0  0  0  0  0  0  0  0  0  0  0  0 -1 -1 -1 -1
 -1 -1 -1  0  0  0  0  0  0  0  0  0  0  0  0  0  0  0  0  0  0  0  0  0  0  0 -1 -1 -1
 -1 -1 -1  0  0  0  0  0  0  0  0  0  0  0  0  0  0  0  0  0  0  0  0  0  0  0 -1 -1 -1
 -1 -1  0  0  0  0  0  0  0  0  0  0  0  0  0  0  0  0  0  0  0  0  0  0  0  0  0 -1 -1
 -1 -1  0  0  0  0  0  0  0  0  0  0  0  0  0  0  0  0  0  0  0  0  0  0  0  0  0 -1 -1
 -1  0  0  0  0  0  0  0  0  0  0  0  0  0  0  0  0  0  0  0  0  0  0  0  0  0  0  0 -1
 -1  0  0  0  0  0  0  0  0  0  0  0  0  0  0  0  0  0  0  0  0  0  0  0  0  0  0  0 -1
 -1  0  0  0  0  0  0  0  0  0  0  0  0  0  0  0  0  0  0  0  0  0  0  0  0  0  0  0 -1
  0  0  0  0  0  0  0  0  0  0  0  0 -1 -1 -1 -1 -1  0  0  0  0  0  0  0  0  0  0  0  0
  0  0  0  0  0  0  0  0  0  0  0  0 -1 -1 -1 -1 -1  0  0  0  0  0  0  0  0  0  0  0  0
  0  0  0  0  0  0  0  0  0  0  0  0 -1 -1 -1 -1 -1  0  0  0  0  0  0  0  0  0  0  0  0
  0  0  0  0  0  0  0  0  0  0  0  0 -1 -1 -1 -1 -1  0  0  0  0  0  0  0  0  0  0  0  0
  0  0  0  0  0  0  0  0  0  0  0  0 -1 -1 -1 -1 -1  0  0  0  0  0  0  0  0  0  0  0  0
 -1  0  0  0  0  0  0  0  0  0  0  0  0  0  0  0  0  0  0  0  0  0  0  0  0  0  0  0 -1
 -1  0  0  0  0  0  0  0  0  0  0  0  0  0  0  0  0  0  0  0  0  0  0  0  0  0  0  0 -1
 -1  0  0  0  0  0  0  0  0  0  0  0  0  0  0  0  0  0  0  0  0  0  0  0  0  0  0  0 -1
 -1 -1  0  0  0  0  0  0  0  0  0  0  0  0  0  0  0  0  0  0  0  0  0  0  0  0  0 -1 -1
 -1 -1 213  0  0  0  0  0  0  0  0  0  0  0  0  0  0  0  0  0  0  0  0  0  0  0 209 -1 -1
 -1 -1 -1  0  0  0  0  0  0  0  0  0  0  0  0  0  0  0  0  0  0  0  0  0  0  0 -1 -1 -1
 -1 -1 -1  0  0  0  0  0  0  0  0  0  0  0  0  0  0  0  0  0  0  0  0  0  0  0 -1 -1 -1
 -1 -1 -1 -1  0  0  0  0  0  0  0  0  0  0  0  0  0  0  0  0  0  0  0  0  0 -1 -1 -1 -1
 -1 -1 -1 -1 -1  0  0  0  0  0  0  0  0  0  0  0  0  0  0  0  0  0  0  0 -1 -1 -1 -1 -1
 -1 -1 -1 -1 -1 -1 -1  0 219  0  0  0  0  0  0  0  0  0  0  0 215  0 -1 -1 -1 -1 -1 -1 -1
 -1 -1 -1 -1 -1 -1 -1 -1 -1  0  0  0  0  0  0  0  0  0  0  0 -1 -1 -1 -1 -1 -1 -1 -1 -1
 -1 -1 -1 -1 -1 -1 -1 -1 -1 -1 -1 -1  0  0  0  0  0 -1 -1 -1 -1 -1 -1 -1 -1 -1 -1 -1 -1
